,Season,Wteam,Wscore,Lteam,Lscore,Wscorediff,Lscorediff,WSeed,LSeed,Round
1,2003,1112,80,1436,51,29,-29,Z01,Z16,1
2,2003,1113,84,1272,71,13,-13,Z10,Z07,1
3,2003,1141,79,1166,73,6,-6,Z11,Z06,1
4,2003,1143,76,1301,74,2,-2,W08,W09,1
5,2003,1163,58,1140,53,5,-5,X05,X12,1
6,2003,1181,67,1161,57,10,-10,Z03,Z14,1
7,2003,1211,74,1153,69,5,-5,Z09,Z08,1
8,2003,1228,65,1443,60,5,-5,Z04,Z13,1
9,2003,1242,64,1429,61,3,-3,Z02,Z15,1
10,2003,1266,72,1221,68,4,-4,Y03,Y14,1
11,2003,1281,72,1356,71,1,-1,Y06,Y11,1
12,2003,1323,70,1454,69,1,-1,Z05,Z12,1
13,2003,1328,71,1354,54,17,-17,W01,W16,1
14,2003,1390,77,1360,69,8,-8,X04,X13,1
15,2003,1409,84,1173,71,13,-13,Y13,Y04,1
16,2003,1458,81,1451,74,7,-7,Y05,Y12,1
17,2003,1120,65,1386,63,2,-2,W10,W07,1
18,2003,1139,47,1280,46,1,-1,W12,W05,1
19,2003,1196,85,1358,55,30,-30,X02,X15,1
20,2003,1231,67,1104,62,5,-5,Y07,Y10,1
21,2003,1246,95,1237,64,31,-31,Y01,Y16,1
22,2003,1257,86,1122,64,22,-22,W04,W13,1
23,2003,1268,75,1423,73,2,-2,X06,X11,1
24,2003,1277,79,1160,64,15,-15,X07,X10,1
25,2003,1329,77,1335,63,14,-14,W06,W11,1
26,2003,1338,87,1447,61,26,-26,Y02,Y15,1
27,2003,1345,80,1261,56,24,-24,X09,X08,1
28,2003,1393,76,1264,65,11,-11,W03,W14,1
29,2003,1400,82,1421,61,21,-21,X01,X16b,1
30,2003,1428,60,1332,58,2,-2,Y09,Y08,1
31,2003,1448,76,1190,73,3,-3,W02,W15,1
32,2003,1462,71,1407,59,12,-12,X03,X14,1
33,2003,1112,96,1211,95,1,-1,Z01,Z09,2
34,2003,1163,85,1390,74,11,-11,X05,X04,2
35,2003,1181,86,1141,60,26,-26,Z03,Z11,2
36,2003,1242,108,1113,76,32,-32,Z02,Z10,2
37,2003,1266,101,1281,92,9,-9,Y03,Y06,2
38,2003,1323,68,1228,60,8,-8,Z05,Z04,2
39,2003,1328,74,1143,65,9,-9,W01,W08,2
40,2003,1458,61,1409,60,1,-1,Y05,Y13,2
41,2003,1120,68,1448,62,6,-6,W10,W02,2
42,2003,1139,79,1257,71,8,-8,W12,W04,2
43,2003,1246,74,1428,54,20,-20,Y01,Y09,2
44,2003,1268,77,1462,64,13,-13,X06,X03,2
45,2003,1277,68,1196,46,22,-22,X07,X02,2
46,2003,1338,74,1231,52,22,-22,Y02,Y07,2
47,2003,1393,68,1329,56,12,-12,W03,W06,2
48,2003,1400,77,1345,67,10,-10,X01,X09,2
49,2003,1112,88,1323,71,17,-17,Z01,Z05,3
50,2003,1242,69,1181,65,4,-4,Z02,Z03,3
51,2003,1246,63,1458,57,6,-6,Y01,Y05,3
52,2003,1266,77,1338,74,3,-3,Y03,Y02,3
53,2003,1277,60,1268,58,2,-2,X07,X06,3
54,2003,1328,65,1139,54,11,-11,W01,W12,3
55,2003,1393,79,1120,78,1,-1,W03,W10,3
56,2003,1400,82,1163,78,4,-4,X01,X05,3
57,2003,1242,78,1112,75,3,-3,Z02,Z01,4
58,2003,1266,83,1246,69,14,-14,Y03,Y01,4
59,2003,1393,63,1328,47,16,-16,W03,W01,4
60,2003,1400,85,1277,76,9,-9,X01,X07,4
61,2003,1242,94,1266,61,33,-33,Z02,Y03,5
62,2003,1393,95,1400,84,11,-11,W03,X01,5
63,2003,1393,81,1242,78,3,-3,W03,Z02,6
65,2004,1104,65,1356,64,1,-1,X08,X09,1
66,2004,1163,70,1436,53,17,-17,X02,X15,1
67,2004,1177,76,1173,69,7,-7,X07,X10,1
68,2004,1181,96,1106,61,35,-35,W01,W16,1
69,2004,1211,76,1434,49,27,-27,Z02,Z15,1
70,2004,1264,75,1196,60,15,-15,Y12,Y05,1
71,2004,1268,86,1431,83,3,-3,X04,X13,1
72,2004,1305,72,1277,66,6,-6,Z10,Z07,1
73,2004,1314,63,1102,52,11,-11,W06,W11,1
74,2004,1371,80,1112,76,4,-4,W08,W09,1
75,2004,1386,82,1251,63,19,-19,Y01,Y16,1
76,2004,1390,71,1427,45,26,-26,X01,X16,1
77,2004,1393,80,1140,75,5,-5,X05,X12,1
78,2004,1400,66,1343,49,17,-17,W03,W14,1
79,2004,1403,76,1150,73,3,-3,Y08,Y09,1
80,2004,1448,79,1433,78,1,-1,Y04,Y13,1
81,2004,1130,58,1428,51,7,-7,Z06,Z11,1
82,2004,1153,80,1190,77,3,-3,W04,W13,1
83,2004,1210,65,1320,60,5,-5,Z03,Z14,1
84,2004,1228,72,1293,53,19,-19,W05,W12,1
85,2004,1242,78,1227,53,25,-25,Z04,Z13,1
86,2004,1246,96,1197,76,20,-20,Z01,Z16a,1
87,2004,1272,59,1376,43,16,-16,Y07,Y10,1
88,2004,1280,85,1284,52,33,-33,W02,W15,1
89,2004,1301,61,1418,52,9,-9,X03,X14,1
90,2004,1329,75,1186,56,19,-19,Y02,Y15,1
91,2004,1334,66,1344,58,8,-8,Z12,Z05,1
92,2004,1338,53,1416,44,9,-9,Y03,Y14,1
93,2004,1412,102,1449,100,2,-2,Z09,Z08,1
94,2004,1435,71,1444,58,13,-13,X06,X11,1
95,2004,1458,76,1350,64,12,-12,Y06,Y11,1
96,2004,1462,80,1257,70,10,-10,W07,W10,1
97,2004,1104,70,1390,67,3,-3,X08,X01,2
98,2004,1163,72,1177,55,17,-17,X02,X07,2
99,2004,1181,90,1371,62,28,-28,W01,W08,2
100,2004,1305,91,1211,72,19,-19,Z10,Z02,2
101,2004,1386,70,1403,65,5,-5,Y01,Y08,2
102,2004,1393,72,1268,70,2,-2,X05,X04,2
103,2004,1400,78,1314,75,3,-3,W03,W06,2
104,2004,1448,84,1264,80,4,-4,Y04,Y12,2
105,2004,1210,57,1130,54,3,-3,Z03,Z06,2
106,2004,1228,92,1153,68,24,-24,W05,W04,2
107,2004,1242,78,1334,63,15,-15,Z04,Z12,2
108,2004,1329,70,1272,53,17,-17,Y02,Y07,2
109,2004,1338,59,1458,55,4,-4,Y03,Y06,2
110,2004,1412,76,1246,75,1,-1,Z09,Z01,2
111,2004,1435,75,1301,73,2,-2,X06,X03,2
112,2004,1462,89,1280,74,15,-15,W07,W02,2
113,2004,1104,80,1393,71,9,-9,X08,X05,3
114,2004,1163,73,1435,53,20,-20,X02,X06,3
115,2004,1329,63,1338,51,12,-12,Y02,Y03,3
116,2004,1386,84,1448,80,4,-4,Y01,Y04,3
117,2004,1181,72,1228,62,10,-10,W01,W05,3
118,2004,1210,72,1305,67,5,-5,Z03,Z10,3
119,2004,1242,100,1412,74,26,-26,Z04,Z09,3
120,2004,1462,79,1400,71,8,-8,W07,W03,3
121,2004,1163,87,1104,71,16,-16,X02,X08,4
122,2004,1329,64,1386,62,2,-2,Y02,Y01,4
123,2004,1181,66,1462,63,3,-3,W01,W07,4
124,2004,1210,79,1242,71,8,-8,Z03,Z04,4
125,2004,1163,79,1181,78,1,-1,X02,W01,5
126,2004,1210,67,1329,65,2,-2,Z03,Y02,5
127,2004,1163,82,1210,73,9,-9,X02,Z03,6
129,2005,1112,66,1429,53,13,-13,X03,X14,1
130,2005,1130,85,1335,65,20,-20,X04,X13,1
131,2005,1153,76,1234,64,12,-12,Y07,Y10,1
132,2005,1211,74,1457,64,10,-10,W03,W14,1
133,2005,1228,67,1192,55,12,-12,X01,X16,1
134,2005,1246,72,1184,64,8,-8,Y02,Y15,1
135,2005,1305,61,1400,57,4,-4,X09,X08,1
136,2005,1328,84,1310,67,17,-17,Y03,Y14,1
137,2005,1334,79,1338,71,8,-8,W08,W09,1
138,2005,1403,78,1417,66,12,-12,W06,W11,1
139,2005,1412,82,1261,68,14,-14,X11,X06,1
140,2005,1428,60,1431,54,6,-6,Y06,Y11,1
141,2005,1448,70,1151,54,16,-16,W02,W15,1
142,2005,1449,88,1285,77,11,-11,W01,W16,1
143,2005,1452,63,1166,61,2,-2,W07,W10,1
144,2005,1454,83,1104,73,10,-10,X12,X05,1
145,2005,1137,64,1242,63,1,-1,Z14,Z03,1
146,2005,1163,77,1416,71,6,-6,Z02,Z15,1
147,2005,1181,57,1175,46,11,-11,Y01,Y16,1
148,2005,1196,67,1325,62,5,-5,Z04,Z13,1
149,2005,1210,80,1203,68,12,-12,W05,W12,1
150,2005,1235,64,1278,53,11,-11,Z09,Z08,1
151,2005,1257,68,1418,62,6,-6,W04,W13,1
152,2005,1277,89,1330,81,8,-8,Y05,Y12,1
153,2005,1280,93,1390,70,23,-23,Y09,Y08,1
154,2005,1301,75,1150,63,12,-12,Z10,Z07,1
155,2005,1314,96,1324,68,28,-28,Z01,Z16b,1
156,2005,1329,63,1368,50,13,-13,X02,X15,1
157,2005,1356,65,1388,56,9,-9,X07,X10,1
158,2005,1436,60,1393,57,3,-3,Y13,Y04,1
159,2005,1437,55,1307,47,8,-8,Z05,Z12,1
160,2005,1458,57,1320,52,5,-5,Z06,Z11,1
161,2005,1112,85,1412,63,22,-22,X03,X11,2
162,2005,1228,71,1305,59,12,-12,X01,X09,2
163,2005,1246,69,1153,60,9,-9,Y02,Y07,2
164,2005,1403,71,1211,69,2,-2,W06,W03,2
165,2005,1428,67,1328,58,9,-9,Y06,Y03,2
166,2005,1449,97,1334,79,18,-18,W01,W08,2
167,2005,1452,111,1448,105,6,-6,W07,W02,2
168,2005,1454,83,1130,75,8,-8,X12,X04,2
169,2005,1181,63,1280,55,8,-8,Y01,Y09,2
170,2005,1257,76,1210,54,22,-22,W04,W05,2
171,2005,1277,72,1436,61,11,-11,Y05,Y13,2
172,2005,1301,65,1163,62,3,-3,Z10,Z02,2
173,2005,1314,92,1235,65,27,-27,Z01,Z09,2
174,2005,1329,85,1356,77,8,-8,X02,X07,2
175,2005,1437,76,1196,65,11,-11,Z05,Z04,2
176,2005,1458,71,1137,62,9,-9,Z06,Z14,2
177,2005,1112,79,1329,78,1,-1,X03,X02,3
178,2005,1228,77,1454,63,14,-14,X01,X12,3
179,2005,1257,93,1449,79,14,-14,W04,W01,3
180,2005,1452,65,1403,60,5,-5,W07,W06,3
181,2005,1246,62,1428,52,10,-10,Y02,Y06,3
182,2005,1277,78,1181,68,10,-10,Y05,Y01,3
183,2005,1314,67,1437,66,1,-1,Z01,Z05,3
184,2005,1458,65,1301,56,9,-9,Z06,Z10,3
185,2005,1228,90,1112,89,1,-1,X01,X03,4
186,2005,1257,93,1452,85,8,-8,W04,W07,4
187,2005,1277,94,1246,88,6,-6,Y05,Y02,4
188,2005,1314,88,1458,82,6,-6,Z01,Z06,4
189,2005,1228,72,1257,57,15,-15,X01,W04,5
190,2005,1314,87,1277,71,16,-16,Z01,Y05,5
191,2005,1314,75,1228,70,5,-5,Z01,X01,6
193,2006,1104,90,1266,85,5,-5,X10,X07,1
194,2006,1130,88,1334,76,12,-12,Y04,Y13,1
195,2006,1181,70,1380,54,16,-16,W01,W16,1
196,2006,1196,76,1375,50,26,-26,Y03,Y14,1
197,2006,1203,88,1423,85,3,-3,W08,W09,1
198,2006,1211,79,1462,75,4,-4,X03,X14,1
199,2006,1228,78,1102,69,9,-9,Z04,Z13,1
200,2006,1231,87,1361,83,4,-4,X06,X11,1
201,2006,1261,80,1233,64,16,-16,W04,W13,1
202,2006,1285,87,1305,79,8,-8,Y12,Y05,1
203,2006,1397,63,1457,61,2,-2,Z02,Z15,1
204,2006,1401,66,1393,58,8,-8,W12,W05,1
205,2006,1417,78,1125,44,34,-34,X02,X15,1
206,2006,1449,75,1429,61,14,-14,Z05,Z12,1
207,2006,1454,82,1328,74,8,-8,Y11,Y06,1
208,2006,1455,86,1371,66,20,-20,Z07,Z10,1
209,2006,1112,94,1458,75,19,-19,Y08,Y09,1
210,2006,1133,77,1242,73,4,-4,X13,X04,1
211,2006,1137,59,1116,55,4,-4,X09,X08,1
212,2006,1163,72,1107,59,13,-13,Z01,Z16,1
213,2006,1206,75,1277,65,10,-10,Z11,Z06,1
214,2006,1207,54,1320,49,5,-5,Y07,Y10,1
215,2006,1246,69,1412,64,5,-5,Z08,Z09,1
216,2006,1272,94,1331,78,16,-16,X01,X16,1
217,2006,1301,58,1143,52,6,-6,W10,W07,1
218,2006,1314,69,1293,65,4,-4,Z03,Z14,1
219,2006,1322,64,1234,63,1,-1,W14,W03,1
220,2006,1326,70,1172,62,8,-8,Y02,Y15,1
221,2006,1338,79,1245,64,15,-15,X05,X12,1
222,2006,1400,60,1335,52,8,-8,W02,W15,1
223,2006,1437,58,1284,45,13,-13,Y01,Y16b,1
224,2006,1452,64,1356,46,18,-18,W06,W11,1
225,2006,1130,69,1285,56,13,-13,Y04,Y12,2
226,2006,1181,74,1203,61,13,-13,W01,W08,2
227,2006,1196,82,1454,60,22,-22,Y03,Y11,2
228,2006,1211,90,1231,80,10,-10,X03,X06,2
229,2006,1261,58,1401,57,1,-1,W04,W12,2
230,2006,1417,62,1104,59,3,-3,X02,X10,2
231,2006,1449,67,1228,64,3,-3,Z05,Z04,2
232,2006,1455,80,1397,73,7,-7,Z07,Z02,2
233,2006,1133,72,1338,66,6,-6,X13,X05,2
234,2006,1163,87,1246,83,4,-4,Z01,Z08,2
235,2006,1206,65,1314,60,5,-5,Z11,Z03,2
236,2006,1207,70,1326,52,18,-18,Y07,Y02,2
237,2006,1272,72,1137,56,16,-16,X01,X09,2
238,2006,1400,75,1301,54,21,-21,W02,W10,2
239,2006,1437,82,1112,78,4,-4,Y01,Y08,2
240,2006,1452,67,1322,54,13,-13,W06,W14,2
241,2006,1261,62,1181,54,8,-8,W04,W01,3
242,2006,1272,80,1133,64,16,-16,X01,X13,3
243,2006,1400,74,1452,71,3,-3,W02,W06,3
244,2006,1417,73,1211,71,2,-2,X02,X03,3
245,2006,1163,98,1449,92,6,-6,Z01,Z05,3
246,2006,1196,57,1207,53,4,-4,Y03,Y07,3
247,2006,1206,63,1455,55,8,-8,Z11,Z07,3
248,2006,1437,60,1130,59,1,-1,Y01,Y04,3
249,2006,1261,70,1400,60,10,-10,W04,W02,4
250,2006,1417,50,1272,45,5,-5,X02,X01,4
251,2006,1196,75,1437,62,13,-13,Y03,Y01,4
252,2006,1206,86,1163,84,2,-2,Z11,Z01,4
253,2006,1196,73,1206,58,15,-15,Y03,Z11,5
254,2006,1417,59,1261,45,14,-14,X02,W04,5
255,2006,1196,73,1417,57,16,-16,Y03,X02,6
257,2007,1130,84,1403,75,9,-9,W07,W10,1
258,2007,1139,57,1330,46,11,-11,Y05,Y12,1
259,2007,1207,80,1125,55,25,-25,W02,W15,1
260,2007,1231,70,1211,57,13,-13,Z07,Z10,1
261,2007,1257,78,1390,58,20,-20,X06,X11,1
262,2007,1268,82,1172,70,12,-12,Y04,Y13,1
263,2007,1277,61,1266,49,12,-12,W09,W08,1
264,2007,1314,86,1184,65,21,-21,W01,W16,1
265,2007,1326,78,1148,57,21,-21,X01,X16,1
266,2007,1338,79,1460,58,21,-21,Z03,Z14,1
267,2007,1401,68,1335,52,16,-16,X03,X14,1
268,2007,1417,70,1451,42,28,-28,Z02,Z15,1
269,2007,1433,79,1181,77,2,-2,Z11,Z06,1
270,2007,1435,77,1203,44,33,-33,W06,W11,1
271,2007,1450,70,1331,54,16,-16,W03,W14,1
272,2007,1462,79,1140,77,2,-2,X09,X08,1
273,2007,1196,112,1238,69,43,-43,Y01,Y16,1
274,2007,1242,107,1310,67,40,-40,Z01,Z16b,1
275,2007,1246,67,1437,58,9,-9,Z08,Z09,1
276,2007,1272,73,1317,58,15,-15,X02,X15,1
277,2007,1305,77,1166,71,6,-6,X07,X10,1
278,2007,1332,58,1275,56,2,-2,Y03,Y14,1
279,2007,1345,72,1112,63,9,-9,Y09,Y08,1
280,2007,1356,61,1221,51,10,-10,Z04,Z13,1
281,2007,1397,121,1253,86,35,-35,X05,X12,1
282,2007,1400,79,1308,67,12,-12,W04,W13,1
283,2007,1424,67,1210,63,4,-4,Y07,Y10,1
284,2007,1425,77,1116,60,17,-17,W05,W12,1
285,2007,1438,84,1107,57,27,-27,X04,X13,1
286,2007,1439,54,1228,52,2,-2,Z05,Z12,1
287,2007,1457,74,1323,64,10,-10,Y11,Y06,1
288,2007,1458,76,1394,63,13,-13,Y02,Y15,1
289,2007,1139,62,1268,59,3,-3,Y05,Y04,2
290,2007,1207,62,1130,55,7,-7,W02,W07,2
291,2007,1314,81,1277,67,14,-14,W01,W09,2
292,2007,1326,78,1462,71,7,-7,X01,X09,2
293,2007,1338,84,1433,79,5,-5,Z03,Z11,2
294,2007,1401,72,1257,69,3,-3,X03,X06,2
295,2007,1417,54,1231,49,5,-5,Z02,Z07,2
296,2007,1435,78,1450,74,4,-4,W06,W03,2
297,2007,1196,74,1345,67,7,-7,Y01,Y09,2
298,2007,1242,88,1246,76,12,-12,Z01,Z08,2
299,2007,1272,78,1305,62,16,-16,X02,X07,2
300,2007,1332,75,1457,61,14,-14,Y03,Y11,2
301,2007,1356,63,1439,48,15,-15,Z04,Z05,2
302,2007,1397,77,1438,74,3,-3,X05,X04,2
303,2007,1424,74,1458,68,6,-6,Y07,Y02,2
304,2007,1425,87,1400,68,19,-19,W05,W04,2
305,2007,1242,61,1356,58,3,-3,Z01,Z04,3
306,2007,1272,65,1401,64,1,-1,X02,X03,3
307,2007,1326,85,1397,84,1,-1,X01,X05,3
308,2007,1417,64,1338,55,9,-9,Z02,Z03,3
309,2007,1196,65,1139,57,8,-8,Y01,Y05,3
310,2007,1207,66,1435,65,1,-1,W02,W06,3
311,2007,1314,74,1425,64,10,-10,W01,W05,3
312,2007,1332,76,1424,72,4,-4,Y03,Y07,3
313,2007,1326,92,1272,76,16,-16,X01,X02,4
314,2007,1417,68,1242,55,13,-13,Z02,Z01,4
315,2007,1196,85,1332,77,8,-8,Y01,Y03,4
316,2007,1207,96,1314,84,12,-12,W02,W01,4
317,2007,1196,76,1417,66,10,-10,Y01,Z02,5
318,2007,1326,67,1207,60,7,-7,X01,W02,5
319,2007,1196,84,1326,75,9,-9,Y01,X01,6
321,2008,1181,71,1125,70,1,-1,Z02,Z15,1
322,2008,1242,85,1340,61,24,-24,X01,X16,1
323,2008,1243,80,1425,67,13,-13,X11,X06,1
324,2008,1266,74,1246,66,8,-8,Y06,Y11,1
325,2008,1277,72,1396,61,11,-11,Y05,Y12,1
326,2008,1323,68,1206,50,18,-18,W05,W12,1
327,2008,1338,82,1331,63,19,-19,Y04,Y13,1
328,2008,1345,90,1124,79,11,-11,Z06,Z11,1
329,2008,1390,77,1165,53,24,-24,Y03,Y14,1
330,2008,1401,67,1140,62,5,-5,Z09,Z08,1
331,2008,1417,70,1290,29,41,-41,Z01,Z16,1
332,2008,1424,71,1245,58,13,-13,X08,X09,1
333,2008,1450,71,1457,40,31,-31,W04,W13,1
334,2008,1452,75,1112,65,10,-10,Z07,Z10,1
335,2008,1458,71,1168,56,15,-15,X03,X14,1
336,2008,1462,73,1208,61,12,-12,Z03,Z14,1
337,2008,1116,86,1231,72,14,-14,W09,W08,1
338,2008,1139,81,1375,61,20,-20,W07,W10,1
339,2008,1172,82,1211,76,6,-6,X10,X07,1
340,2008,1207,66,1420,47,19,-19,X02,X15,1
341,2008,1257,79,1129,61,18,-18,W03,W14,1
342,2008,1272,87,1426,63,24,-24,Y01,Y16,1
343,2008,1274,78,1388,64,14,-14,Y07,Y10,1
344,2008,1280,76,1332,69,7,-7,Y08,Y09,1
345,2008,1314,113,1291,74,39,-39,W01,W16b,1
346,2008,1328,72,1386,64,8,-8,W06,W11,1
347,2008,1360,70,1163,69,1,-1,Z13,Z04,1
348,2008,1373,83,1435,62,21,-21,X13,X04,1
349,2008,1397,72,1110,57,15,-15,W02,W15,1
350,2008,1400,74,1122,54,20,-20,Y02,Y15,1
351,2008,1437,75,1155,69,6,-6,X12,X05,1
352,2008,1443,101,1179,99,2,-2,Z12,Z05,1
353,2008,1242,75,1424,56,19,-19,X01,X08,2
354,2008,1277,65,1338,54,11,-11,Y05,Y04,2
355,2008,1390,82,1266,81,1,-1,Y03,Y06,2
356,2008,1417,51,1401,49,2,-2,Z01,Z09,2
357,2008,1450,61,1323,41,20,-20,W04,W05,2
358,2008,1452,73,1181,67,6,-6,Z07,Z02,2
359,2008,1458,72,1243,55,17,-17,X03,X11,2
360,2008,1462,85,1345,78,7,-7,Z03,Z06,2
361,2008,1172,74,1207,70,4,-4,X10,X02,2
362,2008,1257,78,1328,48,30,-30,W03,W06,2
363,2008,1272,77,1280,74,3,-3,Y01,Y08,2
364,2008,1314,108,1116,77,31,-31,W01,W09,2
365,2008,1397,76,1139,71,5,-5,W02,W07,2
366,2008,1400,75,1274,72,3,-3,Y02,Y07,2
367,2008,1437,84,1373,72,12,-12,X12,X13,2
368,2008,1443,72,1360,63,9,-9,Z12,Z13,2
369,2008,1257,79,1397,60,19,-19,W03,W02,3
370,2008,1314,68,1450,47,21,-21,W01,W04,3
371,2008,1417,88,1443,78,10,-10,Z01,Z12,3
372,2008,1462,79,1452,75,4,-4,Z03,Z07,3
373,2008,1172,73,1458,56,17,-17,X10,X03,3
374,2008,1242,72,1437,57,15,-15,X01,X12,3
375,2008,1272,92,1277,74,18,-18,Y01,Y05,3
376,2008,1400,82,1390,62,20,-20,Y02,Y03,3
377,2008,1314,83,1257,73,10,-10,W01,W03,4
378,2008,1417,76,1462,57,19,-19,Z01,Z03,4
379,2008,1242,59,1172,57,2,-2,X01,X10,4
380,2008,1272,85,1400,67,18,-18,Y01,Y02,4
381,2008,1242,84,1314,66,18,-18,X01,W01,5
382,2008,1272,78,1417,63,15,-15,Y01,Z01,5
383,2008,1242,75,1272,68,7,-7,X01,Y01,6
385,2009,1163,103,1151,47,56,-56,Z01,Z16,1
386,2009,1181,86,1127,62,24,-24,W02,W15,1
387,2009,1211,77,1103,64,13,-13,X04,X13,1
388,2009,1261,75,1139,71,4,-4,X08,X09,1
389,2009,1268,84,1143,71,13,-13,Z10,Z07,1
390,2009,1272,81,1169,70,11,-11,Z02,Z15,1
391,2009,1276,62,1155,59,3,-3,X10,X07,1
392,2009,1314,101,1347,58,43,-43,X01,X16,1
393,2009,1328,82,1288,54,28,-28,X02,X15,1
394,2009,1345,61,1320,56,5,-5,Z05,Z12,1
395,2009,1400,76,1278,62,14,-14,W07,W10,1
396,2009,1401,79,1140,66,13,-13,Z09,Z08,1
397,2009,1417,65,1433,64,1,-1,W06,W11,1
398,2009,1437,80,1110,67,13,-13,W03,W14,1
399,2009,1443,76,1228,72,4,-4,X12,X05,1
400,2009,1449,71,1280,58,13,-13,Z04,Z13,1
401,2009,1112,84,1428,71,13,-13,Y12,Y05,1
402,2009,1113,66,1396,57,9,-9,X06,X11,1
403,2009,1156,84,1448,69,15,-15,Y13,Y04,1
404,2009,1173,68,1452,60,8,-8,Y11,Y06,1
405,2009,1242,84,1295,74,10,-10,Y03,Y14,1
406,2009,1257,74,1287,54,20,-20,Y01,Y16b,1
407,2009,1266,58,1429,57,1,-1,Z06,Z11,1
408,2009,1277,77,1352,62,15,-15,Y02,Y15,1
409,2009,1281,78,1165,59,19,-19,Z03,Z14,1
410,2009,1329,77,1397,75,2,-2,W08,W09,1
411,2009,1338,72,1190,62,10,-10,W01,W16,1
412,2009,1373,74,1326,72,2,-2,Y09,Y08,1
413,2009,1393,59,1372,44,15,-15,X03,X14,1
414,2009,1425,72,1130,55,17,-17,Y10,Y07,1
415,2009,1458,61,1199,59,2,-2,W12,W05,1
416,2009,1462,77,1340,59,18,-18,W04,W13,1
417,2009,1163,92,1401,66,26,-26,Z01,Z09,2
418,2009,1181,74,1400,69,5,-5,W02,W07,2
419,2009,1211,83,1443,81,2,-2,X04,X12,2
420,2009,1272,89,1268,70,19,-19,Z02,Z10,2
421,2009,1314,84,1261,70,14,-14,X01,X08,2
422,2009,1328,73,1276,63,10,-10,X02,X10,2
423,2009,1345,76,1449,74,2,-2,Z05,Z04,2
424,2009,1437,89,1417,69,20,-20,W03,W06,2
425,2009,1112,71,1156,57,14,-14,Y12,Y13,2
426,2009,1242,60,1173,43,17,-17,Y03,Y11,2
427,2009,1257,79,1373,72,7,-7,Y01,Y09,2
428,2009,1277,74,1425,69,5,-5,Y02,Y10,2
429,2009,1281,83,1266,79,4,-4,Z03,Z06,2
430,2009,1338,84,1329,76,8,-8,W01,W08,2
431,2009,1393,78,1113,67,11,-11,X03,X06,2
432,2009,1462,60,1458,49,11,-11,W04,W12,2
433,2009,1163,72,1345,60,12,-12,Z01,Z05,3
434,2009,1281,102,1272,91,11,-11,Z03,Z02,3
435,2009,1338,60,1462,55,5,-5,W01,W04,3
436,2009,1437,77,1181,54,23,-23,W03,W02,3
437,2009,1257,103,1112,64,39,-39,Y01,Y12,3
438,2009,1277,67,1242,62,5,-5,Y02,Y03,3
439,2009,1314,98,1211,77,21,-21,X01,X04,3
440,2009,1328,84,1393,71,13,-13,X02,X03,3
441,2009,1163,82,1281,75,7,-7,Z01,Z03,4
442,2009,1437,78,1338,76,2,-2,W03,W01,4
443,2009,1277,64,1257,52,12,-12,Y02,Y01,4
444,2009,1314,72,1328,60,12,-12,X01,X02,4
445,2009,1277,82,1163,73,9,-9,Y02,Z01,5
446,2009,1314,83,1437,69,14,-14,X01,W03,5
447,2009,1314,89,1277,72,17,-17,X01,Y02,6
449,2010,1124,68,1358,59,9,-9,X03,X14,1
450,2010,1139,77,1431,59,18,-18,Z05,Z12,1
451,2010,1140,99,1196,92,7,-7,Z07,Z10,1
452,2010,1242,90,1250,74,16,-16,Y01,Y16,1
453,2010,1243,82,1317,62,20,-20,Z02,Z15,1
454,2010,1246,100,1190,71,29,-29,W01,W16,1
455,2010,1293,66,1435,65,1,-1,Z13,Z04,1
456,2010,1307,62,1285,57,5,-5,W03,W14,1
457,2010,1320,69,1424,66,3,-3,Y09,Y08,1
458,2010,1325,97,1207,83,14,-14,Y14,Y03,1
459,2010,1330,51,1323,50,1,-1,X11,X06,1
460,2010,1388,80,1350,71,9,-9,X10,X07,1
461,2010,1397,62,1361,59,3,-3,Y06,Y11,1
462,2010,1437,73,1352,70,3,-3,X02,X15,1
463,2010,1448,81,1400,80,1,-1,W09,W08,1
464,2010,1449,80,1266,78,2,-2,W11,W06,1
465,2010,1143,77,1257,62,15,-15,X08,X09,1
466,2010,1165,78,1396,65,13,-13,W12,W05,1
467,2010,1181,73,1115,44,29,-29,X01,X16a,1
468,2010,1210,64,1329,59,5,-5,Y10,Y07,1
469,2010,1211,67,1199,60,7,-7,Z08,Z09,1
470,2010,1268,89,1222,77,12,-12,Y04,Y13,1
471,2010,1277,70,1308,67,3,-3,Y05,Y12,1
472,2010,1281,86,1155,78,8,-8,W10,W07,1
473,2010,1326,68,1364,51,17,-17,Y02,Y15,1
474,2010,1338,89,1324,66,23,-23,Z03,Z14,1
475,2010,1345,72,1373,64,8,-8,X04,X13,1
476,2010,1393,79,1436,56,23,-23,Z01,Z16,1
477,2010,1401,69,1429,53,16,-16,X05,X12,1
478,2010,1452,77,1288,50,27,-27,W02,W15,1
479,2010,1458,53,1459,49,4,-4,W04,W13,1
480,2010,1462,65,1278,54,11,-11,Z06,Z11,1
481,2010,1124,76,1330,68,8,-8,X03,X11,2
482,2010,1139,54,1293,52,2,-2,Z05,Z13,2
483,2010,1243,84,1140,72,12,-12,Z02,Z07,2
484,2010,1246,90,1448,60,30,-30,W01,W09,2
485,2010,1320,69,1242,67,2,-2,Y09,Y01,2
486,2010,1388,75,1437,68,7,-7,X10,X02,2
487,2010,1397,83,1325,68,15,-15,Y06,Y14,2
488,2010,1449,82,1307,64,18,-18,W11,W03,2
489,2010,1165,87,1458,69,18,-18,W12,W04,2
490,2010,1181,68,1143,53,15,-15,X01,X08,2
491,2010,1277,85,1268,83,2,-2,Y05,Y04,2
492,2010,1326,75,1210,66,9,-9,Y02,Y10,2
493,2010,1345,63,1401,61,2,-2,X04,X05,2
494,2010,1393,87,1211,65,22,-22,Z01,Z08,2
495,2010,1452,68,1281,59,9,-9,W02,W10,2
496,2010,1462,71,1338,68,3,-3,Z06,Z03,2
497,2010,1139,63,1393,59,4,-4,Z05,Z01,3
498,2010,1243,101,1462,96,5,-5,Z02,Z06,3
499,2010,1246,62,1165,45,17,-17,W01,W12,3
500,2010,1452,69,1449,56,13,-13,W02,W11,3
501,2010,1124,72,1388,49,23,-23,X03,X10,3
502,2010,1181,70,1345,57,13,-13,X01,X04,3
503,2010,1277,59,1320,52,7,-7,Y05,Y09,3
504,2010,1397,76,1326,73,3,-3,Y06,Y02,3
505,2010,1139,63,1243,56,7,-7,Z05,Z02,4
506,2010,1452,73,1246,66,7,-7,W02,W01,4
507,2010,1181,78,1124,71,7,-7,X01,X03,4
508,2010,1277,70,1397,69,1,-1,Y05,Y06,4
509,2010,1139,52,1277,50,2,-2,Z05,Y05,5
510,2010,1181,78,1452,57,21,-21,X01,W02,5
511,2010,1181,61,1139,59,2,-2,X01,Z05,6
516,2014,1163,89,1386,81,8,-8,W07,W10,1
517,2014,1173,60,1326,59,1,-1,X11,X06,1
518,2014,1196,67,1107,55,12,-12,X01,X16a,1
519,2014,1217,61,1153,57,4,-4,W12,W05,1
520,2014,1257,71,1264,64,7,-7,Y04,Y13,1
521,2014,1276,57,1459,40,17,-17,Y02,Y15,1
522,2014,1277,93,1174,78,15,-15,W04,W13,1
523,2014,1295,80,1328,75,5,-5,Z12,Z05,1
524,2014,1332,87,1140,68,19,-19,Z07,Z10,1
525,2014,1338,77,1160,48,29,-29,X09,X08,1
526,2014,1361,73,1308,69,4,-4,Z04,Z13,1
527,2014,1387,83,1301,80,3,-3,Y05,Y12a,1
528,2014,1393,77,1444,53,24,-24,X03,X14,1
529,2014,1400,87,1113,85,2,-2,Y07,Y10,1
530,2014,1437,73,1454,53,20,-20,W02,W15,1
531,2014,1458,75,1110,35,40,-40,Z02,Z15,1
532,2014,1112,68,1451,59,9,-9,Z01,Z16,1
533,2014,1124,74,1304,60,14,-14,Z06,Z11,1
534,2014,1166,76,1418,66,10,-10,Z03,Z14,1
535,2014,1211,85,1329,77,8,-8,Z08,Z09,1
536,2014,1235,93,1300,75,18,-18,W03,W14,1
537,2014,1242,80,1184,69,11,-11,X02,X15,1
538,2014,1246,56,1243,49,7,-7,Y08,Y09,1
539,2014,1272,71,1203,66,5,-5,W08,W09,1
540,2014,1273,78,1181,71,7,-7,Y14,Y03,1
541,2014,1314,79,1344,77,2,-2,W06,W11,1
542,2014,1372,77,1433,75,2,-2,X12,X05,1
543,2014,1390,58,1307,53,5,-5,X10,X07,1
544,2014,1397,86,1269,67,19,-19,Y11b,Y06,1
545,2014,1417,76,1409,59,17,-17,X04,X13,1
546,2014,1438,70,1157,59,11,-11,W01,W16,1
547,2014,1455,64,1142,37,27,-27,Y01,Y16a,1
548,2014,1163,77,1437,65,12,-12,W07,W02,2
549,2014,1173,55,1393,53,2,-2,X11,X03,2
550,2014,1196,61,1338,45,16,-16,X01,X09,2
551,2014,1257,66,1387,51,15,-15,Y04,Y05,2
552,2014,1276,79,1400,65,14,-14,Y02,Y07,2
553,2014,1277,80,1217,73,7,-7,W04,W12,2
554,2014,1361,63,1295,44,19,-19,Z04,Z12,2
555,2014,1458,85,1332,77,8,-8,Z02,Z07,2
556,2014,1112,84,1211,61,23,-23,Z01,Z08,2
557,2014,1124,85,1166,55,30,-30,Z06,Z03,2
558,2014,1235,85,1314,83,2,-2,W03,W06,2
559,2014,1246,78,1455,76,2,-2,Y08,Y01,2
560,2014,1390,60,1242,57,3,-3,X10,X02,2
561,2014,1397,83,1273,63,20,-20,Y11b,Y14,2
562,2014,1417,77,1372,60,17,-17,X04,X12,2
563,2014,1438,78,1272,60,18,-18,W01,W08,2
564,2014,1112,70,1361,64,6,-6,Z01,Z04,3
565,2014,1173,82,1390,72,10,-10,X11,X10,3
566,2014,1196,79,1417,68,11,-11,X01,X04,3
567,2014,1458,69,1124,52,17,-17,Z02,Z06,3
568,2014,1163,81,1235,76,5,-5,W07,W03,3
569,2014,1246,74,1257,69,5,-5,Y08,Y04,3
570,2014,1276,73,1397,71,2,-2,Y02,Y11b,3
571,2014,1277,61,1438,59,2,-2,W04,W01,3
572,2014,1196,62,1173,52,10,-10,X01,X11,4
573,2014,1458,64,1112,63,1,-1,Z02,Z01,4
574,2014,1163,60,1277,54,6,-6,W07,W04,4
575,2014,1246,75,1276,72,3,-3,Y08,Y02,4
576,2014,1163,63,1196,53,10,-10,W07,X01,5
577,2014,1246,74,1458,73,1,-1,Y08,Z02,5
578,2014,1163,60,1246,54,6,-6,W07,Y08,6
583,2015,1112,93,1411,72,21,-21,Z02,Z15,1
584,2015,1116,56,1459,53,3,-3,Z05,Z12,1
585,2015,1139,56,1400,48,8,-8,Y06,Y11,1
586,2015,1153,66,1345,65,1,-1,Y08,Y09,1
587,2015,1207,84,1186,74,10,-10,X04,X13,1
588,2015,1209,57,1124,56,1,-1,Z14,Z03,1
589,2015,1246,79,1214,56,23,-23,Y01,Y16a,1
590,2015,1301,66,1261,65,1,-1,W08,W09,1
591,2015,1314,67,1217,65,2,-2,Z04,Z13,1
592,2015,1323,69,1318,65,4,-4,Y03,Y14,1
593,2015,1326,75,1433,72,3,-3,Z10,Z07,1
594,2015,1412,60,1235,59,1,-1,X14,X03,1
595,2015,1417,60,1374,59,1,-1,X11,X06,1
596,2015,1428,57,1372,50,7,-7,X05,X12,1
597,2015,1437,93,1248,52,41,-41,W01,W16,1
598,2015,1462,76,1279,57,19,-19,Z06,Z11b,1
599,2015,1173,66,1344,53,13,-13,W11b,W06,1
600,2015,1181,85,1352,56,29,-29,X01,X16b,1
601,2015,1211,86,1295,76,10,-10,X02,X15,1
602,2015,1234,83,1172,52,31,-31,X07,X10,1
603,2015,1242,75,1308,56,19,-19,Y02,Y15,1
604,2015,1257,57,1414,55,2,-2,W04,W13,1
605,2015,1268,65,1434,62,3,-3,Y04,Y13,1
606,2015,1277,70,1208,63,7,-7,W07,W10,1
607,2015,1320,71,1461,54,17,-17,W05,W12,1
608,2015,1328,69,1107,60,9,-9,W03,W14,1
609,2015,1332,79,1329,73,6,-6,Z08,Z09,1
610,2015,1361,76,1385,64,12,-12,X08,X09,1
611,2015,1438,79,1125,67,12,-12,W02,W15,1
612,2015,1452,68,1138,62,6,-6,Y05,Y12,1
613,2015,1455,81,1231,76,5,-5,Y07,Y10,1
614,2015,1458,86,1157,72,14,-14,Z01,Z16,1
615,2015,1112,73,1326,58,15,-15,Z02,Z10,2
616,2015,1246,64,1153,51,13,-13,Y01,Y08,2
617,2015,1301,71,1437,68,3,-3,W08,W01,2
618,2015,1314,87,1116,78,9,-9,Z04,Z05,2
619,2015,1323,67,1139,64,3,-3,Y03,Y06,2
620,2015,1417,92,1412,75,17,-17,X11,X14,2
621,2015,1428,75,1207,64,11,-11,X05,X04,2
622,2015,1462,75,1209,67,8,-8,Z06,Z14,2
623,2015,1181,68,1361,49,19,-19,X01,X08,2
624,2015,1211,87,1234,68,19,-19,X02,X07,2
625,2015,1257,66,1320,53,13,-13,W04,W05,2
626,2015,1277,60,1438,54,6,-6,W07,W02,2
627,2015,1328,72,1173,66,6,-6,W03,W11b,2
628,2015,1452,69,1268,59,10,-10,Y05,Y04,2
629,2015,1455,78,1242,65,13,-13,Y07,Y02,2
630,2015,1458,72,1332,65,7,-7,Z01,Z08,2
631,2015,1112,68,1462,60,8,-8,Z02,Z06,3
632,2015,1246,78,1452,39,39,-39,Y01,Y05,3
633,2015,1323,81,1455,70,11,-11,Y03,Y07,3
634,2015,1458,79,1314,72,7,-7,Z01,Z04,3
635,2015,1181,63,1428,57,6,-6,X01,X05,3
636,2015,1211,74,1417,62,12,-12,X02,X11,3
637,2015,1257,75,1301,65,10,-10,W04,W08,3
638,2015,1277,62,1328,58,4,-4,W07,W03,3
639,2015,1246,68,1323,66,2,-2,Y01,Y03,4
640,2015,1458,85,1112,78,7,-7,Z01,Z02,4
641,2015,1181,66,1211,52,14,-14,X01,X02,4
642,2015,1277,76,1257,70,6,-6,W07,W04,4
643,2015,1181,81,1277,61,20,-20,X01,W07,5
644,2015,1458,71,1246,64,7,-7,Z01,Y01,5
645,2015,1181,68,1458,63,5,-5,X01,Z01,6
650,2016,1114,85,1345,83,2,-2,X12,X05,1
651,2016,1139,71,1403,61,10,-10,X09,X08,1
652,2016,1163,74,1160,67,7,-7,Y09,Y08,1
653,2016,1181,93,1423,85,8,-8,Z04,Z13,1
654,2016,1211,68,1371,52,16,-16,X11,X06,1
655,2016,1231,99,1151,74,25,-25,W05,W12,1
656,2016,1235,94,1233,81,13,-13,X04,X13,1
657,2016,1242,105,1122,79,26,-26,Y01,Y16,1
658,2016,1246,85,1392,57,28,-28,W04,W13,1
659,2016,1274,79,1138,72,7,-7,Y03,Y14,1
660,2016,1314,83,1195,67,16,-16,W01,W16b,1
661,2016,1344,70,1425,69,1,-1,W09,W08,1
662,2016,1428,80,1201,69,11,-11,X03,X14,1
663,2016,1438,81,1214,45,36,-36,X01,X16,1
664,2016,1455,65,1112,55,10,-10,Y11b,Y06,1
665,2016,1463,79,1124,75,4,-4,Z12,Z05,1
666,2016,1218,77,1143,66,11,-11,Y13,Y04,1
667,2016,1234,72,1396,70,2,-2,Y07,Y10,1
668,2016,1268,79,1355,74,5,-5,Y05,Y12,1
669,2016,1292,90,1277,81,9,-9,X15,X02,1
670,2016,1320,75,1400,72,3,-3,Z11,Z06,1
671,2016,1323,70,1276,63,7,-7,W06,W11a,1
672,2016,1328,82,1167,68,14,-14,Z02,Z15,1
673,2016,1332,91,1221,52,39,-39,Z01,Z16a,1
674,2016,1372,70,1452,56,14,-14,W14,W03,1
675,2016,1386,78,1153,76,2,-2,Z08,Z09,1
676,2016,1393,70,1173,51,19,-19,X10,X07,1
677,2016,1401,92,1453,65,27,-27,Z03,Z14,1
678,2016,1433,75,1333,67,8,-8,Z10,Z07,1
679,2016,1437,86,1421,56,30,-30,Y02,Y15,1
680,2016,1458,47,1338,43,4,-4,W07,W10,1
681,2016,1462,71,1451,53,18,-18,W02,W15,1
682,2016,1181,71,1463,64,7,-7,Z04,Z12,2
683,2016,1211,82,1428,59,23,-23,X11,X03,2
684,2016,1231,73,1246,67,6,-6,W05,W04,2
685,2016,1235,78,1114,61,17,-17,X04,X12,2
686,2016,1242,73,1163,61,12,-12,Y01,Y09,2
687,2016,1274,65,1455,57,8,-8,Y03,Y11b,2
688,2016,1314,85,1344,66,19,-19,W01,W09,2
689,2016,1438,77,1139,69,8,-8,X01,X09,2
690,2016,1268,73,1218,60,13,-13,Y05,Y13,2
691,2016,1323,76,1372,75,1,-1,W06,W14,2
692,2016,1328,85,1433,81,4,-4,Z02,Z10,2
693,2016,1332,69,1386,64,5,-5,Z01,Z08,2
694,2016,1393,75,1292,50,25,-25,X10,X15,2
695,2016,1401,92,1320,88,4,-4,Z03,Z11,2
696,2016,1437,87,1234,68,19,-19,Y02,Y07,2
697,2016,1458,66,1462,63,3,-3,W07,W02,2
698,2016,1242,79,1268,63,16,-16,Y01,Y05,3
699,2016,1328,77,1401,63,14,-14,Z02,Z03,3
700,2016,1332,82,1181,68,14,-14,Z01,Z04,3
701,2016,1437,92,1274,69,23,-23,Y02,Y03,3
702,2016,1314,101,1231,86,15,-15,W01,W05,3
703,2016,1323,61,1458,56,5,-5,W06,W07,3
704,2016,1393,63,1211,60,3,-3,X10,X11,3
705,2016,1438,84,1235,71,13,-13,X01,X04,3
706,2016,1328,80,1332,68,12,-12,Z02,Z01,4
707,2016,1437,64,1242,59,5,-5,Y02,Y01,4
708,2016,1314,88,1323,74,14,-14,W01,W06,4
709,2016,1393,68,1438,62,6,-6,X10,X01,4
710,2016,1314,83,1393,66,17,-17,W01,X10,5
711,2016,1437,95,1328,51,44,-44,Y02,Z02,5
712,2016,1437,77,1314,74,3,-3,Y02,W01,6
